5,1,4,0,1,"(11, 3, 9)"
53,1,4,0,1,"(11, 3, 9)"
5,1,4,1,1,"(11, 3, 9)"
27,6,8,1,3,"(1, 1, 1)"
28,12,8,1,3,"(1, 1, 1)"
29,0,4,1,3,"(5, 1, 9)"
30,3,8,1,3,"(1, 1, 1)"
31,9,8,1,3,"(1, 1, 1)"
53,1,4,1,1,"(11, 3, 9)"
5,1,4,2,1,"(11, 3, 9)"
53,1,4,2,1,"(11, 3, 9)"
